Squad,# Pl,Age,Poss,Gls,Ast,G+A,G-PK,PK,PKatt,CrdY,CrdR,xG,npxG,xAG,npxG+xAG,PrgC,PrgP,season,country
Ath Paranaense,36,26.2,56.8,49,32,81,46,3,4,83,1,64.0,61.0,48.2,109.2,741,1772,2019,BR
Atlético Mineiro,32,28.1,49.8,44,26,70,39,5,8,72,5,59.5,53.3,41.2,94.5,720,1538,2019,BR
Avaí,42,26.7,46.3,17,9,26,13,4,5,79,10,34.8,30.9,23.3,54.1,624,1422,2019,BR
Bahia,31,27.0,46.9,43,24,67,34,9,10,68,6,51.7,43.9,35.4,79.3,775,1512,2019,BR
Botafogo (RJ),33,26.9,49.4,29,22,51,26,3,3,95,3,37.9,35.6,27.9,63.5,589,1187,2019,BR
Ceará,33,29.0,45.6,35,24,59,32,3,6,86,2,48.7,43.9,32.5,76.5,758,1545,2019,BR
Chapecoense,36,28.8,44.5,31,22,53,27,4,5,77,5,41.7,37.8,30.0,67.8,673,1175,2019,BR
Corinthians,33,28.0,51.3,41,26,67,37,4,4,70,1,42.4,39.2,30.5,69.7,676,1539,2019,BR
Cruzeiro,35,28.9,52.2,27,17,44,23,4,5,88,6,46.5,42.7,32.9,75.6,704,1840,2019,BR
CSA,40,28.7,40.4,24,15,39,20,4,5,95,4,34.6,30.6,25.0,55.6,527,1070,2019,BR
Flamengo,37,26.8,58.4,85,64,149,79,6,8,90,3,81.6,75.5,63.2,138.7,919,1992,2019,BR
Fluminense,39,25.1,57.1,35,20,55,31,4,5,90,9,54.6,50.6,40.8,91.4,937,1870,2019,BR
Fortaleza,32,28.1,45.4,48,33,81,40,8,9,86,6,50.0,43.0,33.6,76.6,661,1267,2019,BR
Goiás,39,26.4,42.2,44,25,69,40,4,4,87,7,47.2,44.0,31.4,75.4,681,1213,2019,BR
Grêmio,40,27.6,56.6,63,48,111,56,7,9,81,2,57.0,50.0,38.9,89.0,846,1759,2019,BR
Internacional,38,27.9,53.5,43,25,68,42,1,3,94,3,53.0,50.8,37.6,88.4,744,1608,2019,BR
Palmeiras,35,28.5,49.3,61,42,103,56,5,6,73,4,59.7,55.2,44.5,99.7,726,1550,2019,BR
Santos,30,26.5,56.2,58,39,97,53,5,7,108,10,62.1,56.6,43.4,100.1,880,1695,2019,BR
São Paulo,36,26.5,53.3,39,32,71,36,3,4,85,6,44.1,41.1,34.7,75.8,841,1494,2019,BR
Vasco da Gama,39,26.0,44.6,37,20,57,29,8,12,103,4,56.7,47.6,35.9,83.5,659,1317,2019,BR
Arsenal,29,25.8,53.8,56,35,91,53,3,3,88,5,47.0,44.6,31.4,76.1,815,1641,2019,EN
Aston Villa,28,25.7,44.1,40,32,72,39,1,3,70,1,44.3,41.8,34.2,76.0,639,1247,2019,EN
Bournemouth,27,25.2,44.1,38,24,62,34,4,4,78,3,44.8,41.7,30.6,72.3,601,1256,2019,EN
Brighton,25,26.4,52.2,35,24,59,34,1,2,59,2,45.4,43.8,31.6,75.4,669,1675,2019,EN
Burnley,22,28.0,41.9,41,30,71,38,3,3,67,0,47.4,45.3,32.4,77.7,437,890,2019,EN
Chelsea,27,25.5,60.4,69,46,115,62,7,7,60,0,69.2,64.4,46.7,111.1,983,1897,2019,EN
Crystal Palace,25,29.4,44.8,29,20,49,26,3,3,62,2,35.8,33.6,26.0,59.5,596,1223,2019,EN
Everton,24,25.5,49.0,42,32,74,41,1,1,76,3,50.8,50.0,38.1,88.1,623,1430,2019,EN
Leicester City,24,26.1,57.1,65,48,113,60,5,7,43,3,62.2,56.7,44.9,101.6,739,1612,2019,EN
Liverpool,24,26.6,62.9,83,69,152,78,5,5,38,1,68.9,65.0,53.0,118.0,967,1941,2019,EN
Manchester City,24,26.9,66.2,100,69,169,94,6,11,64,4,92.0,83.6,68.4,152.0,1199,2460,2019,EN
Manchester Utd,29,24.8,55.8,65,43,108,55,10,14,73,0,62.2,51.2,38.5,89.7,926,1788,2019,EN
Newcastle Utd,28,26.5,39.0,38,29,67,38,0,1,66,3,35.5,34.8,26.9,61.7,537,844,2019,EN
Norwich City,30,26.0,49.3,25,18,43,23,2,2,68,3,37.0,35.4,27.4,62.8,673,1169,2019,EN
Sheffield Utd,26,26.9,43.1,36,25,61,35,1,1,63,2,43.0,42.2,34.0,76.3,493,1352,2019,EN
Southampton,25,25.9,48.9,51,32,83,49,2,5,55,4,56.1,52.1,36.4,88.5,628,1335,2019,EN
Tottenham,29,26.7,52.0,56,39,95,53,3,4,84,3,47.9,44.7,32.6,77.3,768,1410,2019,EN
Watford,26,28.9,42.9,35,21,56,28,7,8,80,3,48.9,42.6,31.4,74.0,578,1168,2019,EN
West Ham,29,27.4,44.1,49,36,85,45,4,4,64,1,48.6,45.4,36.7,82.2,666,1377,2019,EN
Wolves,21,26.6,48.3,49,34,83,45,4,4,61,2,54.1,51.0,37.5,88.5,858,1338,2019,EN
Alavés,32,27.6,41.5,34,20,54,28,6,6,111,7,39.3,34.7,26.9,61.6,403,944,2019,SP
Athletic Club,26,26.7,48.7,40,23,63,32,8,10,90,2,41.5,33.8,26.2,60.0,604,1291,2019,SP
Atlético Madrid,30,26.1,48.6,50,35,85,44,6,8,93,3,56.8,50.6,39.4,90.0,598,1333,2019,SP
Barcelona,28,27.8,66.4,84,62,146,78,6,6,92,6,66.3,61.7,49.5,111.2,923,2042,2019,SP
Betis,27,27.5,56.7,48,35,83,42,6,8,108,9,51.0,45.2,36.9,82.0,834,1475,2019,SP
Celta Vigo,30,25.8,51.7,37,26,63,31,6,9,104,6,39.2,32.4,26.2,58.7,670,1364,2019,SP
Eibar,26,29.3,46.3,38,24,62,31,7,10,92,3,42.0,34.2,26.0,60.2,424,1265,2019,SP
Espanyol,31,27.7,47.4,25,17,42,21,4,4,107,9,38.6,35.6,27.3,62.9,561,1240,2019,SP
Getafe,30,27.5,45.0,42,31,73,36,6,7,135,5,41.6,36.1,27.9,64.0,416,1196,2019,SP
Granada,27,26.8,43.8,50,34,84,45,5,5,109,1,44.9,40.9,30.5,71.4,511,1009,2019,SP
Leganés,29,26.9,43.9,30,19,49,27,3,5,127,4,39.9,35.9,27.7,63.7,498,1165,2019,SP
Levante,29,27.7,48.3,45,28,73,40,5,5,79,5,48.1,44.2,36.3,80.5,711,1358,2019,SP
Mallorca,32,26.8,45.0,39,21,60,31,8,10,93,5,41.1,33.3,25.4,58.7,740,1210,2019,SP
Osasuna,31,27.7,47.4,46,26,72,38,8,8,110,6,49.4,43.2,34.4,77.6,562,1359,2019,SP
Real Madrid,26,27.6,58.8,69,52,121,58,11,11,82,4,67.9,59.2,49.9,109.1,951,1972,2019,SP
Real Sociedad,27,24.8,56.2,54,38,92,50,4,5,79,2,48.9,45.1,35.4,80.5,737,1588,2019,SP
Sevilla,26,27.7,57.9,53,35,88,46,7,7,97,1,53.2,47.9,38.4,86.3,803,1823,2019,SP
Valencia,28,27.0,49.0,45,34,79,40,5,8,80,8,43.3,37.2,31.7,68.9,671,1378,2019,SP
Valladolid,30,27.1,44.7,31,19,50,28,3,6,84,0,36.6,32.1,24.0,56.1,510,1106,2019,SP
Villarreal,25,27.6,52.9,62,40,102,52,10,11,78,1,63.6,55.2,43.1,98.3,694,1483,2019,SP
Augsburg,28,26.2,38.6,45,29,74,42,3,5,68,2,43.1,39.1,29.7,68.8,411,815,2019,GE
Bayern Munich,29,26.7,65.1,97,75,172,91,6,6,54,3,89.5,84.8,73.1,157.9,930,2300,2019,GE
Dortmund,27,25.8,60.4,84,74,158,82,2,2,49,1,61.0,59.5,50.6,110.1,792,1736,2019,GE
Düsseldorf,28,27.1,45.6,36,26,62,32,4,4,78,0,35.9,32.7,24.2,56.9,487,1268,2019,GE
Eint Frankfurt,27,27.0,50.9,57,45,102,55,2,2,71,4,59.5,58.0,44.8,102.8,677,1389,2019,GE
Freiburg,26,26.4,48.1,46,27,73,41,5,6,43,2,46.7,42.0,33.0,75.0,537,1128,2019,GE
Gladbach,25,26.3,52.4,64,53,117,60,4,6,77,3,72.0,67.2,53.6,120.8,650,1305,2019,GE
Hertha BSC,32,26.2,44.7,45,35,80,42,3,3,78,4,43.1,40.7,32.7,73.4,546,1073,2019,GE
Hoffenheim,31,26.0,51.6,52,36,88,49,3,4,66,2,56.1,53.0,40.2,93.2,598,1261,2019,GE
Köln,29,25.6,46.7,50,38,88,48,2,4,79,4,48.9,46.3,35.6,81.9,494,1158,2019,GE
Leverkusen,24,26.1,63.2,57,48,105,55,2,2,61,6,59.1,57.5,48.6,106.1,761,1471,2019,GE
Mainz 05,25,24.6,43.2,42,34,76,39,3,3,75,3,48.2,45.8,37.4,83.2,524,1146,2019,GE
Paderborn 07,27,25.7,45.9,37,26,63,35,2,4,84,3,39.2,36.1,26.8,62.9,682,1009,2019,GE
RB Leipzig,29,24.2,55.3,81,58,139,76,5,5,53,3,71.3,67.6,54.4,122.0,759,1700,2019,GE
Schalke 04,29,24.6,49.0,35,25,60,33,2,2,64,2,37.8,36.2,25.5,61.7,603,1201,2019,GE
Union Berlin,26,27.7,41.9,38,27,65,34,4,5,71,5,41.4,37.6,28.0,65.7,387,944,2019,GE
Werder Bremen,30,26.7,48.8,40,30,70,37,3,6,80,4,39.4,34.7,25.8,60.5,509,1309,2019,GE
Wolfsburg,26,26.0,48.4,48,33,81,44,4,4,71,4,52.8,49.7,37.9,87.6,620,1247,2019,GE
Atalanta,30,27.2,57.2,96,68,164,89,7,10,80,2,83.5,75.6,58.9,134.5,978,1867,2019,IT
Bologna,31,27.2,52.6,48,31,79,43,5,6,109,7,56.9,52.2,41.3,93.5,799,1672,2019,IT
Brescia,32,25.6,40.6,34,22,56,30,4,4,95,6,43.4,40.2,28.8,69.0,537,1241,2019,IT
Cagliari,33,27.4,45.7,50,34,84,46,4,6,108,6,41.8,37.1,32.0,69.0,662,1288,2019,IT
Fiorentina,33,25.1,47.4,48,30,78,39,9,11,105,5,53.6,45.4,34.5,79.8,857,1446,2019,IT
Genoa,34,26.8,49.5,46,28,74,35,11,16,107,10,48.7,36.2,27.6,63.7,583,1280,2019,IT
Hellas Verona,30,26.1,49.8,45,27,72,37,8,9,87,7,50.5,43.6,34.5,78.1,728,1575,2019,IT
Inter,29,27.7,54.2,80,57,137,70,10,11,104,6,69.4,60.8,44.0,104.7,797,1820,2019,IT
Juventus,30,28.6,58.1,73,47,120,60,13,14,87,3,71.1,60.1,45.5,105.6,879,1746,2019,IT
Lazio,27,27.9,50.4,77,45,122,62,15,18,99,2,68.0,53.9,42.5,96.4,935,1668,2019,IT
Lecce,30,28.7,44.8,52,30,82,41,11,15,98,5,54.7,43.5,32.6,76.1,752,1356,2019,IT
Milan,32,24.6,54.9,60,38,98,52,8,9,97,6,62.8,56.0,46.0,101.9,816,1717,2019,IT
Napoli,25,26.9,59.2,60,45,105,55,5,5,73,2,61.7,57.8,46.8,104.6,979,2024,2019,IT
Parma,25,28.8,43.8,53,38,91,49,4,6,81,1,48.4,43.7,33.9,77.6,673,1227,2019,IT
Roma,31,26.9,52.7,73,47,120,61,12,14,111,7,73.2,62.8,48.6,111.3,944,1651,2019,IT
Sampdoria,31,26.0,42.7,48,25,73,39,9,12,111,7,50.2,40.8,30.8,71.6,613,1369,2019,IT
Sassuolo,31,26.4,57.5,69,49,118,64,5,6,99,3,52.9,48.2,39.2,87.4,902,1590,2019,IT
SPAL,34,27.5,46.9,27,17,44,22,5,7,98,4,40.7,35.2,26.5,61.7,696,1236,2019,IT
Torino,27,27.3,47.4,44,29,73,37,7,8,96,7,44.8,39.4,30.3,69.6,843,1220,2019,IT
Udinese,25,26.5,44.7,37,26,63,37,0,0,77,3,41.6,41.6,33.5,75.2,709,1274,2019,IT
Ath Paranaense,41,25.4,53.8,38,27,65,38,0,1,80,3,45.6,44.8,32.6,77.4,578,1622,2020,BR
Atl Goianiense,35,24.9,46.8,39,31,70,35,4,4,77,5,44.3,41.1,34.2,75.3,668,1424,2020,BR
Atlético Mineiro,34,25.8,60.6,60,42,102,52,8,13,64,3,68.5,58.2,45.5,103.7,695,2219,2020,BR
Bahia,39,27.3,46.8,48,35,83,43,5,8,84,6,55.9,49.6,38.7,88.3,691,1506,2020,BR
Botafogo (RJ),45,24.9,47.8,32,17,49,26,6,7,72,6,51.3,45.8,34.1,79.9,604,1427,2020,BR
Ceará,34,27.9,43.6,52,37,89,46,6,7,93,7,51.8,46.4,36.4,82.8,574,1344,2020,BR
Corinthians,36,27.6,49.9,44,34,78,40,4,5,85,8,44.1,40.2,31.6,71.8,606,1639,2020,BR
Coritiba,47,26.7,46.6,31,21,52,26,5,6,87,8,37.9,33.3,27.2,60.5,566,1286,2020,BR
Flamengo,38,26.6,60.3,67,50,117,60,7,10,88,3,78.4,71.5,57.8,129.3,919,2171,2020,BR
Fluminense,37,26.8,48.7,52,34,86,46,6,7,85,4,41.3,35.9,27.9,63.8,545,1349,2020,BR
Fortaleza,31,28.9,49.8,33,24,57,28,5,8,83,8,43.2,37.4,30.8,68.2,598,1396,2020,BR
Goiás,49,26.0,42.4,39,21,60,35,4,5,114,4,39.5,35.6,25.1,60.7,491,1099,2020,BR
Grêmio,37,27.8,52.4,51,35,86,46,5,7,81,8,54.3,48.8,39.6,88.4,743,1598,2020,BR
Internacional,39,27.1,49.4,59,40,99,50,9,10,91,8,55.3,47.4,35.4,82.8,663,1391,2020,BR
Palmeiras,36,26.4,52.1,51,33,84,46,5,7,92,5,52.6,47.5,37.1,84.6,609,1606,2020,BR
Red Bull Bragantino,35,25.3,49.4,50,35,85,46,4,8,73,4,53.3,47.1,36.6,83.7,730,1701,2020,BR
Santos,40,24.6,50.7,49,32,81,38,11,13,82,5,50.9,40.9,32.3,73.2,638,1346,2020,BR
São Paulo,28,26.5,57.2,59,36,95,53,6,7,90,2,54.3,48.9,36.2,85.1,701,1692,2020,BR
Sport Recife,38,27.0,45.0,31,18,49,23,8,8,88,4,34.7,28.6,21.2,49.8,569,1347,2020,BR
Vasco da Gama,34,26.2,46.6,37,20,57,34,3,4,87,6,41.1,38.0,26.8,64.8,659,1294,2020,BR
Arsenal,29,25.9,53.5,53,38,91,47,6,6,49,5,51.7,47.0,35.1,82.1,758,1760,2020,EN
Aston Villa,24,25.2,48.5,52,38,90,47,5,6,71,4,52.5,47.9,37.4,85.3,629,1420,2020,EN
Brighton,27,25.8,51.1,39,24,63,33,6,9,49,6,50.9,43.8,33.2,77.0,685,1516,2020,EN
Burnley,25,28.3,42.1,32,20,52,29,3,3,48,0,39.3,36.9,27.7,64.6,389,1012,2020,EN
Chelsea,27,26.0,60.9,56,38,94,48,8,10,51,3,62.4,54.5,41.5,96.0,895,1798,2020,EN
Crystal Palace,24,29.1,40.6,39,29,68,36,3,4,56,2,34.1,31.0,23.6,54.6,526,1132,2020,EN
Everton,29,26.3,46.4,45,32,77,41,4,5,59,2,45.7,41.9,30.7,72.6,604,1184,2020,EN
Fulham,28,25.2,49.7,26,18,44,23,3,6,67,3,40.5,35.9,26.3,62.2,727,1354,2020,EN
Leeds United,23,26.1,57.3,60,45,105,56,4,4,61,1,55.6,52.5,41.9,94.3,811,1633,2020,EN
Leicester City,27,26.5,54.3,64,45,109,54,10,12,61,0,55.8,46.3,33.7,80.1,666,1464,2020,EN
Liverpool,28,26.8,62.1,65,43,108,59,6,6,40,0,67.5,62.9,48.3,111.2,886,2057,2020,EN
Manchester City,24,26.1,63.5,82,55,137,77,5,9,46,2,68.2,61.2,45.4,106.6,1096,2051,2020,EN
Manchester Utd,29,25.6,55.7,70,51,121,60,10,11,64,1,60.1,51.4,41.6,93.1,877,1832,2020,EN
Newcastle Utd,27,27.1,38.8,44,26,70,38,6,7,65,3,43.4,37.8,29.0,66.8,467,903,2020,EN
Sheffield Utd,27,26.7,41.7,19,13,32,16,3,4,73,3,32.6,29.5,24.9,54.4,491,1196,2020,EN
Southampton,29,26.6,52.0,47,33,80,42,5,6,52,3,41.2,36.6,25.8,62.5,626,1195,2020,EN
Tottenham,24,27.2,51.6,66,50,116,61,5,5,57,2,53.1,49.2,35.3,84.4,633,1330,2020,EN
West Brom,30,26.4,37.9,33,20,53,29,4,4,51,4,35.8,32.7,24.4,57.1,441,1027,2020,EN
West Ham,24,27.8,43.2,60,46,106,58,2,4,50,3,55.4,52.1,39.6,91.7,658,1282,2020,EN
Wolves,27,26.3,49.3,34,21,55,30,4,4,55,1,36.5,33.4,24.1,57.6,800,1283,2020,EN
Alavés,30,28.7,42.8,35,21,56,30,5,8,96,8,42.6,36.4,27.4,63.7,404,938,2020,SP
Athletic Club,27,26.6,49.9,43,31,74,39,4,5,82,3,43.1,39.2,31.3,70.5,685,1496,2020,SP
Atlético Madrid,25,27.3,52.3,65,54,119,60,5,7,100,0,52.8,47.2,40.6,87.8,694,1604,2020,SP
Barcelona,25,26.4,65.5,80,51,131,76,4,8,72,2,73.5,67.1,53.2,120.2,972,2157,2020,SP
Betis,25,27.9,53.6,50,35,85,42,8,11,93,8,49.1,40.5,33.4,73.9,694,1441,2020,SP
Cádiz,34,28.8,34.8,33,16,49,29,4,4,81,3,34.7,31.6,20.4,52.0,455,854,2020,SP
Celta Vigo,30,26.6,53.3,55,39,94,48,7,7,109,5,50.4,44.9,36.7,81.6,514,1308,2020,SP
Eibar,30,28.2,49.3,29,20,49,25,4,9,71,3,45.2,38.3,29.9,68.2,507,1295,2020,SP
Elche,30,28.1,47.5,33,25,58,31,2,3,99,3,29.9,27.5,21.8,49.4,500,927,2020,SP
Getafe,31,26.7,43.3,27,14,41,24,3,5,120,7,34.4,30.5,23.6,54.1,443,1090,2020,SP
Granada,34,27.4,41.4,47,30,77,44,3,5,97,6,41.1,37.3,26.8,64.0,411,975,2020,SP
Huesca,27,28.0,48.3,32,23,55,29,3,4,69,2,38.9,36.1,26.7,62.8,618,1185,2020,SP
Levante,29,28.0,52.2,45,35,80,42,3,6,68,1,40.4,35.7,29.6,65.3,619,1537,2020,SP
Osasuna,28,27.9,43.2,36,25,61,31,5,6,80,5,38.7,34.7,24.9,59.7,345,1220,2020,SP
Real Madrid,30,27.9,59.3,64,53,117,61,3,3,59,2,61.5,59.2,47.4,106.5,963,1920,2020,SP
Real Sociedad,30,25.0,54.9,58,39,97,49,9,12,81,1,60.7,51.5,39.6,91.1,626,1554,2020,SP
Sevilla,26,28.1,60.9,52,36,88,46,6,7,79,2,54.4,48.9,41.0,90.0,691,1627,2020,SP
Valencia,30,25.2,46.9,48,35,83,40,8,10,82,5,42.6,34.8,27.3,62.1,575,1180,2020,SP
Valladolid,32,28.1,45.2,34,21,55,27,7,8,93,4,40.1,33.8,24.2,58.0,564,1101,2020,SP
Villarreal,29,28.0,55.2,57,33,90,45,12,13,67,5,56.4,46.4,40.5,86.9,737,1628,2020,SP
Arminia,26,26.0,42.3,23,16,39,22,1,2,52,1,32.9,31.3,23.9,55.2,358,880,2020,GE
Augsburg,25,27.0,41.4,35,23,58,33,2,5,71,4,37.3,33.4,25.9,59.3,431,987,2020,GE
Bayern Munich,29,27.3,60.7,98,75,173,89,9,10,44,3,75.9,68.1,55.2,123.3,829,2084,2020,GE
Dortmund,26,25.6,59.6,74,57,131,71,3,7,44,1,66.2,60.4,51.2,111.5,763,1745,2020,GE
Eint Frankfurt,25,27.2,53.7,63,52,115,55,8,8,82,1,58.5,52.2,44.0,96.2,664,1548,2020,GE
Freiburg,24,26.2,47.3,51,34,85,45,6,6,62,0,45.5,40.9,29.5,70.4,463,1170,2020,GE
Gladbach,23,26.9,51.7,63,44,107,53,10,11,61,2,54.9,46.5,37.1,83.6,613,1371,2020,GE
Hertha BSC,32,25.4,49.6,40,29,69,36,4,6,67,3,41.9,37.2,29.1,66.2,589,1176,2020,GE
Hoffenheim,30,25.7,51.2,51,38,89,46,5,6,68,4,51.9,47.3,37.4,84.6,581,1517,2020,GE
Köln,28,24.9,46.3,33,23,56,29,4,6,63,1,40.5,35.9,25.5,61.5,429,1131,2020,GE
Leverkusen,30,25.4,59.7,52,41,93,49,3,3,58,0,46.3,44.0,34.7,78.7,724,1522,2020,GE
Mainz 05,31,25.8,40.7,39,23,62,34,5,5,63,1,49.9,46.0,34.9,80.9,442,1046,2020,GE
RB Leipzig,25,25.0,59.7,59,44,103,51,8,10,57,0,64.4,56.7,43.7,100.4,624,1719,2020,GE
Schalke 04,42,25.9,44.7,24,20,44,24,0,3,74,2,28.7,26.3,20.6,46.9,452,943,2020,GE
Stuttgart,29,24.1,51.5,54,42,96,48,6,8,65,2,51.4,45.1,37.1,82.2,701,1467,2020,GE
Union Berlin,27,27.3,44.9,50,39,89,45,5,7,57,2,46.9,41.3,33.4,74.7,464,1059,2020,GE
Werder Bremen,27,26.3,43.9,35,25,60,30,5,5,67,3,32.9,29.0,21.5,50.5,414,1065,2020,GE
Wolfsburg,26,25.6,51.1,57,48,105,55,2,3,58,3,49.0,46.9,37.7,84.5,595,1397,2020,GE
Atalanta,30,27.3,54.6,90,65,155,84,6,7,67,3,74.7,69.3,55.5,124.7,874,2077,2020,IT
Benevento,29,28.7,42.6,40,26,66,35,5,7,95,5,40.6,35.0,27.6,62.6,512,1096,2020,IT
Bologna,37,27.2,50.8,49,38,87,46,3,4,82,4,54.6,51.1,39.0,90.1,706,1516,2020,IT
Cagliari,32,26.5,44.8,43,30,73,39,4,5,77,3,47.1,43.4,34.0,77.5,589,1228,2020,IT
Crotone,31,27.8,46.3,44,27,71,35,9,9,89,4,40.4,33.4,23.9,57.2,582,1217,2020,IT
Fiorentina,30,26.6,46.3,44,31,75,38,6,6,86,5,44.9,40.2,31.6,71.8,637,1353,2020,IT
Genoa,34,28.3,44.8,46,32,78,42,4,4,87,2,38.8,35.6,26.4,62.0,523,1165,2020,IT
Hellas Verona,32,26.2,49.8,38,30,68,35,3,3,91,1,45.3,43.0,33.5,76.5,599,1490,2020,IT
Inter,25,27.7,52.5,84,62,146,76,8,9,61,2,74.2,67.2,52.5,119.8,766,1707,2020,IT
Juventus,30,27.7,56.9,76,59,135,68,8,10,80,6,74.4,67.0,55.1,122.1,949,1768,2020,IT
Lazio,30,29.4,53.0,59,40,99,53,6,10,107,5,58.2,50.7,39.6,90.2,785,1688,2020,IT
Milan,29,24.4,51.7,72,47,119,57,15,20,83,4,70.7,56.0,43.9,99.8,784,1483,2020,IT
Napoli,25,27.1,55.1,83,56,139,76,7,8,76,3,67.7,61.4,46.9,108.3,884,1703,2020,IT
Parma,42,28.0,47.8,39,26,65,34,5,5,91,1,42.5,38.6,30.5,69.0,607,1319,2020,IT
Roma,31,26.7,52.2,67,51,118,60,7,8,91,3,65.3,59.0,48.2,107.2,863,1583,2020,IT
Sampdoria,27,27.9,45.2,52,37,89,47,5,6,83,3,45.4,41.1,31.9,73.0,588,1370,2020,IT
Sassuolo,28,26.5,60.3,61,36,97,48,13,14,79,4,58.4,47.7,34.0,81.8,770,1746,2020,IT
Spezia,35,25.2,51.9,52,37,89,48,4,5,100,5,46.6,42.7,31.1,73.8,627,1388,2020,IT
Torino,29,26.9,47.3,49,28,77,44,5,6,78,4,50.0,45.3,32.2,77.5,617,1138,2020,IT
Udinese,33,27.2,46.3,40,30,70,36,4,4,65,2,45.7,42.9,30.0,72.9,672,1405,2020,IT
América (MG),36,29.2,47.6,41,27,68,35,6,9,64,1,56.1,49.1,38.6,87.7,736,1507,2021,BR
Ath Paranaense,40,25.2,49.0,41,31,72,39,2,2,83,3,41.8,40.2,31.0,71.2,579,1437,2021,BR
Atl Goianiense,31,26.5,49.4,32,20,52,28,4,4,89,2,37.0,33.9,26.5,60.4,559,1401,2021,BR
Atlético Mineiro,35,27.8,56.2,67,47,114,57,10,11,79,2,57.8,49.3,39.6,88.9,616,1756,2021,BR
Bahia,38,27.2,47.1,42,29,71,38,4,5,94,5,45.6,41.7,32.8,74.5,630,1511,2021,BR
Ceará,38,27.2,46.6,38,23,61,35,3,4,89,4,47.9,44.9,33.0,77.9,548,1386,2021,BR
Chapecoense,42,25.5,42.6,26,17,43,22,4,5,77,5,39.5,35.8,27.1,62.9,504,1106,2021,BR
Corinthians,33,28.3,54.6,39,29,68,34,5,6,62,3,40.2,35.5,28.6,64.1,656,1554,2021,BR
Cuiabá,30,28.5,46.3,32,20,52,28,4,4,87,6,36.6,33.4,27.1,60.5,567,1351,2021,BR
Flamengo,41,27.4,58.5,67,55,122,64,3,4,84,3,66.5,63.4,50.3,113.7,894,2055,2021,BR
Fluminense,36,26.5,49.7,37,27,64,33,4,5,85,3,44.3,40.4,31.2,71.6,565,1415,2021,BR
Fortaleza,28,27.8,49.9,43,26,69,39,4,7,90,4,50.6,44.9,32.6,77.5,628,1474,2021,BR
Grêmio,39,26.9,51.9,43,33,76,40,3,7,102,7,50.5,45.1,37.2,82.3,813,1621,2021,BR
Internacional,36,26.2,50.8,43,33,76,37,6,6,105,11,50.6,45.9,39.0,84.9,672,1354,2021,BR
Juventude,35,27.2,44.6,34,18,52,29,5,6,89,3,37.5,33.1,23.4,56.6,494,1181,2021,BR
Palmeiras,46,26.8,50.1,54,41,95,50,4,5,84,7,56.3,52.8,41.4,94.2,694,1499,2021,BR
Red Bull Bragantino,39,23.8,49.6,53,44,97,51,2,4,89,2,47.2,44.1,34.6,78.7,661,1467,2021,BR
Santos,38,25.6,53.4,34,22,56,28,6,8,90,1,44.7,38.5,29.3,67.8,792,1546,2021,BR
São Paulo,31,26.5,56.1,30,20,50,26,4,4,95,4,45.5,42.4,31.4,73.8,677,1633,2021,BR
Sport Recife,38,26.1,46.0,24,15,39,21,3,4,89,4,39.8,36.7,28.4,65.1,585,1258,2021,BR
Arsenal,27,24.4,52.8,60,41,101,55,5,8,67,4,60.5,55.1,40.2,95.4,734,1655,2021,EN
Aston Villa,31,26.1,46.5,50,42,92,47,3,3,81,2,44.0,42.0,34.8,76.8,653,1300,2021,EN
Brentford,29,25.4,44.8,46,33,79,40,6,6,65,3,45.8,41.1,33.0,74.1,450,1189,2021,EN
Brighton,26,26.2,54.4,40,30,70,36,4,7,72,2,46.2,40.7,32.3,72.9,676,1547,2021,EN
Burnley,23,28.5,40.2,32,26,58,31,1,2,68,2,39.7,38.1,31.2,69.3,388,972,2021,EN
Chelsea,26,27.4,61.8,75,52,127,67,8,9,63,1,63.4,56.6,44.9,101.5,894,1967,2021,EN
Crystal Palace,24,27.1,51.1,50,31,81,44,6,8,69,1,46.4,40.1,31.0,71.1,592,1229,2021,EN
Everton,33,26.7,40.0,42,29,71,36,6,7,82,6,41.2,35.8,28.5,64.3,512,1100,2021,EN
Leeds United,29,26.1,52.3,42,26,68,37,5,5,101,3,44.4,40.4,31.3,71.8,671,1483,2021,EN
Leicester City,28,26.5,52.0,62,46,108,60,2,2,55,1,47.8,46.2,34.2,80.4,622,1356,2021,EN
Liverpool,27,27.7,62.7,94,71,165,87,7,8,50,1,88.7,82.7,63.5,146.2,885,2243,2021,EN
Manchester City,26,27.0,67.9,96,63,159,89,7,9,42,1,88.7,81.4,65.5,146.9,1145,2421,2021,EN
Manchester Utd,29,27.2,52.7,56,46,102,53,3,5,77,2,55.8,51.9,42.5,94.3,784,1568,2021,EN
Newcastle Utd,29,27.5,40.4,41,23,64,38,3,3,81,2,38.1,35.9,25.8,61.7,544,923,2021,EN
Norwich City,28,26.2,42.9,21,16,37,18,3,3,57,1,32.3,30.0,24.3,54.3,566,1031,2021,EN
Southampton,25,25.7,47.7,41,26,67,37,4,4,65,2,44.8,41.6,32.5,74.1,728,1326,2021,EN
Tottenham,25,26.5,51.8,63,50,113,58,5,5,69,1,61.2,57.3,47.0,104.4,791,1459,2021,EN
Watford,30,28.4,40.7,33,26,59,32,1,2,63,3,40.0,38.4,32.5,70.9,557,1070,2021,EN
West Ham,25,28.2,47.9,58,46,104,54,4,6,52,3,51.4,46.8,37.4,84.2,646,1449,2021,EN
Wolves,26,27.3,49.5,35,22,57,34,1,1,62,2,37.5,36.8,26.4,63.2,723,1283,2021,EN
Alavés,33,27.9,42.0,29,20,49,23,6,7,93,4,37.3,31.8,25.5,57.3,420,984,2021,SP
Athletic Club,26,26.9,48.1,40,34,74,37,3,7,90,4,49.6,44.0,37.5,81.6,653,1572,2021,SP
Atlético Madrid,26,28.1,50.6,63,45,108,59,4,5,111,7,54.4,50.6,40.2,90.8,705,1463,2021,SP
Barcelona,38,26.2,64.2,68,52,120,62,6,7,97,5,63.4,57.9,47.6,105.5,961,2079,2021,SP
Betis,31,28.9,53.7,60,45,105,54,6,6,87,6,53.5,48.8,37.7,86.5,666,1518,2021,SP
Cádiz,33,28.5,41.3,35,21,56,32,3,6,105,3,39.5,34.8,24.6,59.4,571,1080,2021,SP
Celta Vigo,25,28.4,55.2,43,29,72,40,3,6,87,3,43.1,38.3,28.8,67.2,665,1447,2021,SP
Elche,28,29.1,48.4,39,29,68,38,1,1,104,6,33.7,32.9,27.6,60.5,531,1102,2021,SP
Espanyol,34,27.7,46.9,39,25,64,34,5,5,99,7,36.7,32.9,25.8,58.7,610,1212,2021,SP
Getafe,31,26.6,41.5,31,26,57,28,3,5,121,8,29.3,25.3,19.4,44.7,399,917,2021,SP
Granada,32,28.1,44.7,43,28,71,40,3,5,105,4,39.0,35.1,26.7,61.8,435,1047,2021,SP
Levante,31,28.0,47.2,51,34,85,43,8,13,109,6,55.1,45.1,31.7,76.9,569,1343,2021,SP
Mallorca,33,27.9,45.3,33,23,56,27,6,7,114,7,38.8,33.3,25.7,59.0,575,1129,2021,SP
Osasuna,29,27.7,46.9,37,23,60,31,6,8,84,2,36.7,30.7,22.9,53.6,417,1328,2021,SP
Rayo Vallecano,28,27.5,49.9,38,28,66,34,4,4,101,3,42.8,39.7,30.7,70.3,697,1312,2021,SP
Real Madrid,31,27.7,59.9,80,59,139,72,8,12,76,0,71.7,62.2,50.7,112.9,1029,2078,2021,SP
Real Sociedad,32,25.7,54.3,40,22,62,31,9,10,77,4,51.5,43.8,32.9,76.7,667,1462,2021,SP
Sevilla,33,28.6,59.4,51,40,91,49,2,3,97,4,42.4,40.0,32.5,72.5,625,1596,2021,SP
Valencia,34,24.8,43.6,45,30,75,37,8,9,134,8,39.0,32.2,25.4,57.6,554,1202,2021,SP
Villarreal,29,28.0,56.8,62,51,113,57,5,6,81,1,64.2,60.0,50.9,110.9,790,1698,2021,SP
Arminia,26,25.8,40.7,26,18,44,24,2,2,55,2,26.3,24.7,17.2,41.9,405,887,2021,GE
Augsburg,26,26.6,41.5,39,26,65,34,5,5,74,0,36.7,32.8,23.9,56.7,441,895,2021,GE
Bayern Munich,30,26.8,64.5,92,70,162,87,5,5,36,2,89.0,85.1,66.7,151.8,833,2164,2021,GE
Bochum,28,28.0,44.7,37,22,59,33,4,6,55,2,40.6,35.9,26.7,62.6,467,926,2021,GE
Dortmund,33,25.9,59.2,81,57,138,70,11,11,63,1,64.0,55.9,45.0,100.8,670,1468,2021,GE
Eint Frankfurt,27,26.2,49.6,43,33,76,42,1,2,61,1,41.6,40.1,32.0,72.1,609,1255,2021,GE
Freiburg,26,26.5,49.0,55,37,92,50,5,6,34,0,50.4,45.7,34.5,80.2,401,1229,2021,GE
Gladbach,26,26.0,54.0,54,38,92,49,5,7,67,1,56.2,50.6,37.8,88.4,527,1291,2021,GE
Greuther Fürth,29,25.9,43.6,26,15,41,21,5,5,61,0,30.0,26.2,18.8,44.9,413,976,2021,GE
Hertha BSC,36,26.7,43.7,35,23,58,32,3,3,62,2,33.3,30.9,25.0,55.9,462,975,2021,GE
Hoffenheim,32,26.1,53.2,55,42,97,55,0,0,75,0,58.3,58.3,46.8,105.1,588,1474,2021,GE
Köln,26,27.0,54.8,52,40,92,51,1,1,68,1,50.1,49.3,38.6,87.9,550,1406,2021,GE
Leverkusen,29,24.4,53.7,76,58,134,74,2,6,66,2,62.6,57.8,46.2,104.0,709,1341,2021,GE
Mainz 05,28,26.2,46.5,49,36,85,45,4,4,62,4,50.4,47.2,36.4,83.6,445,1178,2021,GE
RB Leipzig,29,25.3,56.1,72,53,125,64,8,9,49,0,64.5,58.4,49.2,107.6,542,1467,2021,GE
Stuttgart,34,24.0,50.7,40,31,71,39,1,3,64,2,43.7,41.4,33.1,74.5,571,1269,2021,GE
Union Berlin,28,28.3,43.7,50,33,83,45,5,5,62,1,47.0,43.3,31.5,74.8,429,1123,2021,GE
Wolfsburg,30,26.0,50.5,42,25,67,39,3,4,61,3,47.7,44.9,33.8,78.7,502,1220,2021,GE
Atalanta,32,27.5,55.0,62,48,110,57,5,6,87,2,62.4,58.1,48.5,106.6,796,1858,2021,IT
Bologna,36,26.6,50.6,43,34,77,39,4,5,92,7,44.9,41.0,33.6,74.6,540,1276,2021,IT
Cagliari,33,26.5,44.5,34,26,60,31,3,4,96,5,39.0,36.4,29.6,66.0,474,1088,2021,IT
Empoli,28,24.5,47.4,47,27,74,40,7,7,87,5,44.9,39.3,28.9,68.3,658,1477,2021,IT
Fiorentina,28,26.4,57.7,59,33,92,50,9,12,89,8,60.0,50.8,39.2,90.1,755,1584,2021,IT
Genoa,40,27.0,43.9,26,19,45,20,6,7,92,3,37.2,31.8,26.3,58.1,517,1101,2021,IT
Hellas Verona,31,26.8,50.6,63,44,107,56,7,8,100,7,50.4,44.2,34.1,78.4,677,1587,2021,IT
Inter,27,28.9,56.5,83,57,140,76,7,11,71,0,81.6,73.6,57.3,130.9,782,1778,2021,IT
Juventus,32,27.4,51.5,56,37,93,51,5,6,77,2,51.4,46.7,36.3,83.0,701,1464,2021,IT
Lazio,27,29.0,55.4,74,48,122,67,7,9,88,5,55.3,48.2,38.8,87.0,788,1527,2021,IT
Milan,28,25.6,54.0,66,39,105,61,5,8,76,3,59.7,54.1,42.8,96.9,806,1486,2021,IT
Napoli,27,27.9,58.3,74,46,120,64,10,14,63,2,57.8,46.6,37.1,83.7,827,1665,2021,IT
Roma,29,26.4,51.4,58,31,89,51,7,9,111,8,65.1,58.1,46.3,104.4,733,1587,2021,IT
Salernitana,42,27.7,41.2,32,19,51,28,4,5,94,5,36.5,32.9,24.8,57.7,528,1031,2021,IT
Sampdoria,34,29.0,46.1,42,29,71,40,2,4,94,4,36.7,33.4,26.2,59.6,467,1187,2021,IT
Sassuolo,29,26.1,54.9,60,39,99,53,7,7,92,4,55.7,50.2,39.0,89.2,815,1507,2021,IT
Spezia,30,24.4,42.7,38,25,63,35,3,5,88,4,40.1,36.2,27.9,64.1,511,999,2021,IT
Torino,31,25.2,53.3,43,27,70,37,6,6,89,3,48.7,44.1,36.3,80.4,628,1320,2021,IT
Udinese,29,26.2,42.7,58,36,94,55,3,4,95,6,51.3,48.2,36.6,84.8,669,1226,2021,IT
Venezia,39,26.1,42.3,34,23,57,31,3,5,110,9,36.5,32.4,26.4,58.8,540,1088,2021,IT
América (MG),37,29.8,45.9,40,29,69,35,5,7,86,5,45.6,40.8,33.3,74.0,697,1634,2022,BR
Ath Paranaense,35,24.4,44.1,45,26,71,36,9,11,92,4,47.1,38.7,28.6,67.3,565,1274,2022,BR
Atl Goianiense,33,26.9,50.6,38,25,63,36,2,3,100,6,43.1,40.8,32.0,72.8,705,1531,2022,BR
Atlético Mineiro,32,28.7,58.6,43,27,70,38,5,6,90,0,54.1,49.4,38.4,87.8,694,1820,2022,BR
Avaí,45,28.7,50.2,34,10,44,21,13,14,104,4,44.0,33.7,24.0,57.7,563,1345,2022,BR
Botafogo (RJ),43,27.5,48.7,40,21,61,36,4,4,97,4,40.8,38.2,30.5,68.7,626,1299,2022,BR
Ceará,40,29.0,50.9,32,12,44,27,5,7,126,10,43.9,38.4,29.8,68.2,610,1472,2022,BR
Corinthians,42,26.9,54.7,42,28,70,39,3,3,77,3,40.9,38.7,28.7,67.4,606,1493,2022,BR
Coritiba,41,27.5,45.2,39,26,65,35,4,4,110,11,42.3,39.7,32.0,71.7,624,1343,2022,BR
Cuiabá,35,28.3,44.2,31,16,47,27,4,5,83,6,41.0,37.2,27.9,65.1,538,1374,2022,BR
Flamengo,44,27.2,57.3,59,49,108,56,3,6,84,4,65.4,60.6,50.6,111.2,787,1966,2022,BR
Fluminense,32,28.4,60.8,62,47,109,58,4,4,80,9,50.1,47.1,37.6,84.7,773,1625,2022,BR
Fortaleza,34,28.5,45.2,45,36,81,43,2,6,85,4,44.5,41.0,32.2,73.1,614,1385,2022,BR
Goiás,36,26.8,40.2,40,28,68,34,6,6,114,5,34.6,30.3,23.6,53.9,494,972,2022,BR
Internacional,37,27.4,50.0,58,40,98,50,8,10,86,2,55.8,48.1,40.0,88.1,750,1504,2022,BR
Juventude,45,27.4,45.8,27,18,45,25,2,4,109,8,33.4,30.3,21.6,52.0,509,1216,2022,BR
Palmeiras,35,26.9,54.3,64,47,111,57,7,9,75,3,69.3,62.4,48.2,110.6,750,1718,2022,BR
Red Bull Bragantino,36,23.8,49.7,48,29,77,44,4,5,86,6,52.7,48.7,36.9,85.6,659,1508,2022,BR
Santos,40,25.4,48.1,42,31,73,39,3,3,100,3,46.2,43.8,33.4,77.2,661,1394,2022,BR
São Paulo,39,26.8,55.5,55,38,93,50,5,7,103,6,49.7,44.4,35.6,79.9,651,1694,2022,BR
Arsenal,26,24.7,59.3,84,64,148,81,3,4,51,0,71.6,68.9,53.5,122.4,824,2049,2022,EN
Aston Villa,26,27.0,49.3,49,35,84,46,3,4,80,1,50.3,47.2,38.8,86.0,637,1242,2022,EN
Bournemouth,31,26.3,40.4,37,24,61,37,0,0,68,0,38.5,38.5,28.4,66.9,504,1006,2022,EN
Brentford,25,26.2,43.8,56,36,92,49,7,8,57,1,56.3,50.1,38.4,88.5,392,1131,2022,EN
Brighton,29,26.3,60.2,68,46,114,62,6,6,58,0,73.3,68.9,52.2,121.2,809,1849,2022,EN
Chelsea,32,26.3,58.7,37,27,64,34,3,3,81,3,49.5,47.2,38.6,85.8,829,1737,2022,EN
Crystal Palace,26,26.7,46.3,38,29,67,37,1,3,82,3,39.3,36.8,29.0,65.8,556,1243,2022,EN
Everton,28,26.6,42.8,32,24,56,29,3,3,81,2,45.2,42.8,32.4,75.1,500,1052,2022,EN
Fulham,29,28.2,48.8,52,33,85,47,5,9,80,1,46.2,39.1,28.5,67.7,663,1326,2022,EN
Leeds United,29,25.3,47.0,45,31,76,44,1,3,89,3,47.3,44.9,31.8,76.7,555,1429,2022,EN
Leicester City,28,26.1,47.7,49,36,85,46,3,6,63,2,50.5,45.7,38.4,84.1,580,1304,2022,EN
Liverpool,28,27.4,60.8,71,58,129,69,2,4,57,1,71.5,68.4,55.6,124.1,719,1992,2022,EN
Manchester City,24,27.2,64.7,92,69,161,83,9,10,44,1,78.6,71.1,57.5,128.6,988,2073,2022,EN
Manchester Utd,26,26.9,53.7,56,42,98,53,3,3,78,2,67.7,65.3,52.2,117.5,711,1595,2022,EN
Newcastle Utd,27,27.3,52.3,64,42,106,58,6,6,61,1,71.9,67.3,51.8,119.1,695,1618,2022,EN
Nott'ham Forest,33,26.5,37.6,36,22,58,33,3,6,84,0,39.3,34.6,26.3,61.0,436,859,2022,EN
Southampton,36,24.7,44.5,36,25,61,34,2,4,73,0,37.8,34.6,28.1,62.7,588,1125,2022,EN
Tottenham,29,27.6,50.0,68,46,114,63,5,6,77,3,57.0,52.3,43.0,95.4,692,1449,2022,EN
West Ham,25,28.2,42.1,41,25,66,35,6,8,44,0,49.2,43.7,32.7,76.4,615,1274,2022,EN
Wolves,32,26.7,49.9,28,12,40,25,3,3,85,6,36.8,34.5,25.4,60.0,610,1343,2022,EN
Almería,29,26.4,45.1,49,33,82,47,2,3,98,4,45.5,43.2,32.5,75.6,569,1090,2022,SP
Athletic Club,26,27.4,51.6,46,33,79,41,5,7,81,5,54.2,48.7,38.9,87.6,864,1816,2022,SP
Atlético Madrid,27,28.5,50.6,68,51,119,67,1,1,92,8,61.9,61.1,48.0,109.1,730,1571,2022,SP
Barcelona,29,25.9,64.3,69,56,125,69,0,2,84,6,75.5,74.0,60.1,134.1,963,2181,2022,SP
Betis,30,28.6,50.6,43,26,69,35,8,9,83,15,51.3,44.3,34.6,78.9,620,1272,2022,SP
Cádiz,38,29.1,41.9,29,20,49,25,4,5,116,7,41.5,37.7,27.7,65.4,475,969,2022,SP
Celta Vigo,26,26.7,50.2,41,31,72,39,2,3,85,6,42.6,40.3,30.8,71.1,704,1403,2022,SP
Elche,32,28.3,45.5,30,21,51,26,4,5,99,12,37.5,33.6,27.1,60.7,561,1197,2022,SP
Espanyol,33,27.6,43.1,51,31,82,46,5,5,99,10,48.3,44.4,35.0,79.4,528,1146,2022,SP
Getafe,25,27.4,39.9,34,21,55,29,5,8,126,9,36.7,30.4,22.5,53.0,365,1003,2022,SP
Girona,29,26.0,51.3,55,41,96,47,8,9,92,3,50.6,43.8,37.5,81.3,725,1378,2022,SP
Mallorca,31,27.7,41.1,36,27,63,32,4,5,120,5,35.2,31.1,26.5,57.7,476,948,2022,SP
Osasuna,26,27.5,48.0,36,30,66,32,4,5,93,7,39.8,35.9,28.4,64.3,545,1356,2022,SP
Rayo Vallecano,28,27.9,51.2,41,29,70,37,4,8,90,6,43.9,37.8,30.0,67.8,703,1390,2022,SP
Real Madrid,26,27.4,60.9,73,56,129,64,9,12,72,3,75.5,66.1,56.8,122.9,1008,2017,2022,SP
Real Sociedad,30,25.9,54.6,47,36,83,45,2,4,90,2,52.9,49.7,39.7,89.4,692,1483,2022,SP
Sevilla,35,28.7,52.6,47,31,78,43,4,5,121,13,46.3,42.4,32.0,74.5,558,1513,2022,SP
Valencia,28,24.2,52.0,40,23,63,35,5,8,93,8,49.3,43.0,32.5,75.5,786,1472,2022,SP
Valladolid,36,27.4,48.7,32,24,56,29,3,4,94,6,38.5,35.4,28.4,63.7,610,1244,2022,SP
Villarreal,32,28.4,56.9,57,33,90,53,4,7,91,4,61.6,56.1,43.2,99.3,846,1622,2022,SP
Augsburg,34,25.9,41.7,41,29,70,37,4,5,96,5,34.7,30.9,24.3,55.2,331,847,2022,GE
Bayern Munich,28,26.6,64.2,90,67,157,87,3,5,49,3,75.0,71.0,56.6,127.7,863,2041,2022,GE
Bochum,26,29.4,46.1,37,28,65,34,3,3,64,1,40.0,37.7,28.4,66.0,350,1022,2022,GE
Dortmund,30,25.8,58.2,81,61,142,77,4,6,66,0,71.1,66.5,51.9,118.4,783,1628,2022,GE
Eint Frankfurt,28,26.4,52.9,56,33,89,50,6,6,71,1,52.1,47.4,36.2,83.5,632,1372,2022,GE
Freiburg,27,27.4,48.1,51,34,85,44,7,8,62,2,47.9,41.6,28.5,70.1,427,1039,2022,GE
Gladbach,27,26.8,53.7,52,39,91,48,4,6,62,3,52.1,47.5,41.2,88.7,518,1168,2022,GE
Hertha BSC,32,26.0,42.0,42,23,65,35,7,7,82,1,39.4,33.9,25.3,59.2,413,914,2022,GE
Hoffenheim,31,26.8,48.3,46,30,76,39,7,9,80,5,48.0,41.1,32.4,73.4,457,1175,2022,GE
Köln,27,26.0,49.9,46,31,77,42,4,4,75,3,47.9,44.7,35.1,79.9,522,1247,2022,GE
Leverkusen,27,24.7,52.0,57,44,101,52,5,7,75,7,51.4,46.0,38.9,85.0,678,1243,2022,GE
Mainz 05,27,27.0,44.8,54,35,89,50,4,6,69,1,47.1,42.4,30.0,72.4,364,1155,2022,GE
RB Leipzig,25,26.3,58.1,64,39,103,58,6,7,69,2,62.7,57.4,43.2,100.6,599,1450,2022,GE
Schalke 04,35,27.5,46.0,32,24,56,28,4,5,68,1,39.6,35.9,28.7,64.6,415,934,2022,GE
Stuttgart,30,24.7,50.2,45,34,79,40,5,5,72,5,47.6,43.7,38.1,81.7,609,1278,2022,GE
Union Berlin,28,27.9,43.8,49,38,87,46,3,7,65,2,37.9,32.5,25.9,58.4,375,1012,2022,GE
Werder Bremen,25,27.4,49.3,50,37,87,45,5,6,76,1,41.1,36.4,29.0,65.4,412,1140,2022,GE
Wolfsburg,28,24.8,50.6,55,44,99,51,4,7,63,0,51.3,45.8,39.2,84.9,455,1306,2022,GE
Atalanta,27,26.5,49.9,64,42,106,58,6,8,83,3,57.7,51.3,42.7,93.9,687,1637,2022,IT
Bologna,27,26.6,54.7,52,41,93,46,6,6,84,3,43.8,39.4,31.5,70.9,564,1366,2022,IT
Cremonese,33,26.0,42.1,35,18,53,30,5,7,81,3,38.7,33.2,24.3,57.5,521,1107,2022,IT
Empoli,32,25.3,47.3,35,20,55,33,2,2,88,7,38.8,37.2,26.8,64.0,608,1114,2022,IT
Fiorentina,30,26.5,56.1,51,37,88,47,4,6,93,3,55.0,50.8,40.2,91.0,789,1627,2022,IT
Hellas Verona,36,26.6,41.2,29,22,51,28,1,1,103,3,35.8,35.1,28.1,63.2,503,1063,2022,IT
Inter,25,28.8,55.7,68,50,118,64,4,5,65,3,68.0,64.5,51.8,116.3,668,1624,2022,IT
Juventus,29,27.7,49.6,56,41,97,53,3,6,74,6,55.3,50.4,39.8,90.2,673,1394,2022,IT
Lazio,24,28.6,52.1,59,37,96,53,6,8,87,2,51.1,44.9,34.3,79.2,683,1381,2022,IT
Lecce,29,24.8,41.3,31,21,52,27,4,6,86,2,36.1,31.4,25.3,56.7,515,1232,2022,IT
Milan,30,26.0,55.6,61,49,110,56,5,5,90,2,58.8,55.1,46.0,101.1,795,1584,2022,IT
Monza,31,26.6,55.2,46,31,77,41,5,6,90,4,45.9,41.2,33.8,75.0,708,1362,2022,IT
Napoli,27,26.4,61.8,75,57,132,67,8,10,47,1,64.7,56.8,46.8,103.6,907,1804,2022,IT
Roma,30,27.4,48.6,50,33,83,43,7,10,83,4,57.4,49.9,38.9,88.8,684,1217,2022,IT
Salernitana,30,27.2,44.9,46,34,80,44,2,2,85,4,36.7,35.2,26.9,62.0,519,1089,2022,IT
Sampdoria,40,27.9,46.1,23,18,41,22,1,2,108,3,34.1,32.5,24.4,56.9,466,1126,2022,IT
Sassuolo,31,26.1,49.2,46,30,76,37,9,10,90,6,51.6,43.9,36.1,80.0,761,1565,2022,IT
Spezia,34,25.7,47.4,29,18,47,25,4,4,103,6,41.5,38.5,29.3,67.8,553,1163,2022,IT
Torino,28,25.2,53.2,41,34,75,39,2,2,81,0,41.8,40.2,35.0,75.2,684,1328,2022,IT
Udinese,30,26.1,48.0,46,41,87,45,1,2,88,3,46.9,45.4,37.8,83.2,646,1354,2022,IT
América (MG),46,29.1,43.0,42,30,72,38,4,6,89,10,46.7,42.1,34.4,76.5,638,1387,2023,BR
Ath Paranaense,40,26.1,48.5,51,38,89,47,4,4,109,4,51.1,48.2,38.9,87.1,592,1362,2023,BR
Atlético Mineiro,31,28.7,52.7,51,35,86,45,6,6,113,5,46.5,42.3,32.9,75.2,669,1399,2023,BR
Bahia,35,26.9,49.6,48,28,76,44,4,4,100,5,50.6,47.6,31.8,79.4,688,1502,2023,BR
Botafogo (RJ),36,28.5,48.1,56,40,96,51,5,7,93,4,50.1,44.6,33.1,77.6,658,1438,2023,BR
Corinthians,36,27.4,48.8,45,28,73,39,6,7,91,3,40.5,35.1,27.0,62.1,649,1377,2023,BR
Coritiba,47,27.1,43.9,40,25,65,32,8,9,124,5,39.3,32.2,25.6,57.8,551,1147,2023,BR
Cruzeiro,38,27.8,51.4,32,26,58,30,2,4,101,4,48.2,45.0,35.2,80.2,636,1650,2023,BR
Cuiabá,30,28.1,43.7,39,24,63,32,7,8,91,3,38.7,32.7,24.8,57.5,577,1361,2023,BR
Flamengo,32,26.7,57.4,55,39,94,47,8,9,85,5,50.0,43.0,34.4,77.3,713,1953,2023,BR
Fluminense,37,29.2,61.5,51,36,87,48,3,5,124,9,49.9,46.0,36.0,82.0,847,1623,2023,BR
Fortaleza,32,29.7,46.6,44,29,73,39,5,7,97,1,51.5,46.0,35.1,81.1,695,1451,2023,BR
Goiás,42,27.7,44.6,35,22,57,30,5,5,107,6,36.6,32.8,24.5,57.3,523,1284,2023,BR
Grêmio,44,27.9,46.7,61,45,106,56,5,7,103,5,49.9,44.5,36.4,81.0,541,1541,2023,BR
Internacional,35,28.5,51.6,45,30,75,42,3,4,111,6,42.4,39.1,29.0,68.1,618,1389,2023,BR
Palmeiras,33,26.9,52.7,62,44,106,60,2,4,96,4,57.2,54.1,43.1,97.2,788,1593,2023,BR
Red Bull Bragantino,35,24.2,56.5,48,30,78,45,3,3,109,6,57.9,55.5,39.1,94.6,721,1768,2023,BR
Santos,46,26.5,44.4,37,26,63,31,6,6,105,8,42.6,37.9,28.9,66.8,709,1237,2023,BR
São Paulo,38,26.7,59.5,40,27,67,35,5,9,107,5,49.5,42.1,33.1,75.2,694,1665,2023,BR
Vasco da Gama,38,26.2,48.8,41,30,71,37,4,4,101,6,47.6,44.5,32.4,76.9,664,1358,2023,BR
Arsenal,25,25.0,58.2,86,62,148,76,10,10,64,2,76.1,68.5,55.3,123.8,821,2106,2023,EN
Aston Villa,31,26.9,53.1,72,55,127,68,4,4,94,2,63.3,60.3,48.6,108.9,775,1451,2023,EN
Bournemouth,30,25.7,44.4,52,39,91,50,2,3,79,3,55.9,53.6,40.5,94.0,709,1314,2023,EN
Brentford,28,26.6,45.2,54,38,92,51,3,3,89,2,58.2,56.0,42.7,98.8,505,1283,2023,EN
Brighton,30,25.9,59.8,50,36,86,45,5,6,90,3,56.8,52.2,41.6,93.8,864,1780,2023,EN
Burnley,31,24.5,47.4,40,30,70,37,3,3,77,7,40.6,38.3,29.7,68.0,727,1181,2023,EN
Chelsea,32,24.2,58.6,76,51,127,65,11,12,109,4,74.5,65.1,51.4,116.5,873,1615,2023,EN
Crystal Palace,26,26.7,42.3,56,43,99,52,4,4,73,2,48.6,45.4,38.7,84.1,506,1176,2023,EN
Everton,26,27.1,40.8,40,17,57,38,2,3,82,1,54.0,51.6,38.1,89.8,495,1129,2023,EN
Fulham,25,28.4,50.6,54,40,94,52,2,2,84,4,50.8,49.2,37.6,86.8,670,1467,2023,EN
Liverpool,30,26.3,61.3,80,60,140,74,6,9,69,5,87.8,80.4,63.7,144.1,924,2110,2023,EN
Luton Town,28,26.7,42.4,49,33,82,44,5,5,71,0,42.4,38.6,29.5,68.2,675,1113,2023,EN
Manchester City,25,26.6,65.2,94,69,163,85,9,10,53,2,80.5,72.9,60.2,133.1,1127,2060,2023,EN
Manchester Utd,31,26.1,50.6,57,36,93,51,6,7,83,1,56.5,51.0,40.1,91.0,759,1479,2023,EN
Newcastle Utd,32,27.2,52.2,83,55,138,75,8,9,79,1,76.0,69.0,51.3,120.3,737,1557,2023,EN
Nott'ham Forest,33,25.7,40.6,49,43,92,48,1,1,82,3,49.9,49.1,38.0,87.1,604,1140,2023,EN
Sheffield Utd,35,25.7,35.8,31,18,49,26,5,5,101,5,38.3,34.4,25.8,60.2,343,884,2023,EN
Tottenham,29,25.2,61.6,69,58,127,67,2,2,92,4,68.2,66.7,57.4,124.1,957,2107,2023,EN
West Ham,26,28.3,41.1,58,40,98,54,4,5,82,3,52.3,48.4,34.8,83.2,556,1207,2023,EN
Wolves,27,26.6,48.9,47,36,83,43,4,4,102,4,46.7,43.6,31.8,75.4,671,1180,2023,EN
Alavés,30,25.6,41.8,33,28,61,30,3,7,84,1,46.2,40.7,32.4,73.0,550,1260,2023,SP
Almería,35,25.6,46.4,42,25,67,40,2,2,93,6,48.7,47.1,34.2,81.4,590,1097,2023,SP
Athletic Club,27,27.3,49.8,59,41,100,56,3,5,80,5,52.7,48.7,37.0,85.8,735,1610,2023,SP
Atlético Madrid,27,29.2,50.8,68,48,116,63,5,6,89,5,62.4,57.9,47.4,105.2,758,1597,2023,SP
Barcelona,29,26.0,64.3,76,55,131,70,6,7,87,2,77.6,72.1,57.4,129.5,964,1925,2023,SP
Betis,35,27.8,50.4,46,31,77,44,2,3,87,3,43.9,41.7,32.7,74.4,676,1441,2023,SP
Cádiz,34,28.5,43.3,25,17,42,22,3,3,107,7,36.0,33.6,25.2,58.9,456,1017,2023,SP
Celta Vigo,31,26.7,46.1,45,35,80,42,3,5,66,5,50.7,46.9,38.2,85.1,660,1345,2023,SP
Getafe,33,27.3,44.8,42,27,69,36,6,7,135,10,45.7,40.2,27.9,68.0,439,1141,2023,SP
Girona,25,26.1,56.9,84,64,148,77,7,8,75,1,70.8,64.6,54.0,118.6,894,1685,2023,SP
Granada,40,26.7,45.6,35,27,62,30,5,8,98,4,42.6,36.4,31.1,67.6,512,1044,2023,SP
Las Palmas,29,25.5,59.2,33,23,56,30,3,5,84,5,33.2,29.2,23.3,52.5,577,1596,2023,SP
Mallorca,25,28.7,45.0,33,27,60,32,1,3,105,4,40.5,38.2,30.8,69.0,498,1174,2023,SP
Osasuna,29,27.7,47.5,45,32,77,41,4,5,78,5,40.5,36.6,28.5,65.1,501,1322,2023,SP
Rayo Vallecano,26,29.4,49.4,29,12,41,23,6,6,108,5,42.3,37.7,24.6,62.3,506,1335,2023,SP
Real Madrid,27,27.4,59.2,85,66,151,83,2,5,69,4,68.8,65.2,52.5,117.7,950,1935,2023,SP
Real Sociedad,31,25.8,55.3,48,36,84,44,4,4,98,2,44.9,41.8,30.7,72.5,685,1414,2023,SP
Sevilla,35,28.6,50.3,46,30,76,44,2,2,108,4,44.9,43.3,31.7,75.0,635,1416,2023,SP
Valencia,29,23.8,44.3,39,24,63,31,8,9,64,5,43.1,36.2,27.0,63.2,522,1162,2023,SP
Villarreal,32,27.9,49.6,64,47,111,59,5,7,110,8,55.6,50.1,40.5,90.6,654,1558,2023,SP
Augsburg,29,26.0,43.9,49,35,84,44,5,7,71,3,46.1,40.7,27.7,68.4,462,1137,2023,GE
Bayern Munich,30,27.4,61.3,93,71,164,88,5,5,47,2,85.2,81.3,65.9,147.3,944,1941,2023,GE
Bochum,25,29.1,46.6,41,30,71,37,4,4,97,2,44.5,41.4,30.4,71.8,400,1151,2023,GE
Darmstadt 98,32,27.1,45.7,28,21,49,25,3,3,83,4,32.3,30.0,22.8,52.8,437,1083,2023,GE
Dortmund,32,26.8,57.8,68,49,117,62,6,6,59,4,63.5,58.8,45.6,104.4,770,1452,2023,GE
Eint Frankfurt,34,25.3,52.1,48,36,84,46,2,3,70,5,46.2,44.4,34.1,78.5,574,1305,2023,GE
Freiburg,25,27.0,46.6,43,32,75,36,7,9,64,4,49.4,42.4,32.4,74.8,468,1208,2023,GE
Gladbach,27,25.4,46.8,55,43,98,50,5,6,66,2,46.5,41.8,35.5,77.4,598,1227,2023,GE
Heidenheim,22,26.7,42.5,46,34,80,44,2,3,54,1,39.4,37.0,27.5,64.5,510,983,2023,GE
Hoffenheim,30,27.7,49.5,65,47,112,59,6,6,86,5,53.6,49.0,39.9,88.9,538,1359,2023,GE
Köln,26,25.4,46.5,28,17,45,23,5,6,71,4,39.3,34.7,27.2,61.9,618,1086,2023,GE
Leverkusen,24,26.2,61.8,87,71,158,79,8,8,59,0,73.6,67.6,55.2,122.8,888,1997,2023,GE
Mainz 05,30,26.7,46.1,38,31,69,37,1,5,99,3,44.6,40.7,32.0,72.7,480,1169,2023,GE
RB Leipzig,26,25.6,55.3,74,53,127,70,4,7,61,1,65.6,60.2,47.7,107.9,714,1541,2023,GE
Stuttgart,27,25.0,59.9,78,60,138,73,5,8,56,1,70.9,64.6,53.3,117.9,693,1618,2023,GE
Union Berlin,30,28.1,42.9,33,23,56,30,3,6,67,7,40.1,35.3,25.0,60.3,389,1146,2023,GE
Werder Bremen,30,27.0,46.8,45,33,78,40,5,6,73,2,46.9,42.0,35.6,77.6,492,1172,2023,GE
Wolfsburg,28,25.6,48.0,41,27,68,39,2,3,86,5,39.2,36.7,28.5,65.2,441,1235,2023,GE
Atalanta,29,26.3,51.0,72,57,129,67,5,5,76,1,57.8,53.9,43.9,97.8,715,1754,2023,IT
Bologna,28,25.2,58.1,52,32,84,48,4,5,85,2,47.9,44.0,32.1,76.1,660,1453,2023,IT
Cagliari,29,26.1,42.1,41,30,71,37,4,6,77,4,42.9,38.4,29.1,67.5,529,1109,2023,IT
Empoli,34,26.0,44.0,26,19,45,21,5,5,88,1,36.2,32.4,25.8,58.3,524,1056,2023,IT
Fiorentina,30,27.0,57.4,60,41,101,56,4,8,80,0,51.7,45.4,35.3,80.7,621,1656,2023,IT
Frosinone,34,24.3,49.7,44,29,73,36,8,10,68,2,45.8,37.9,30.2,68.1,563,1326,2023,IT
Genoa,34,26.7,44.1,43,27,70,38,5,6,79,3,35.7,31.0,22.8,53.8,468,1079,2023,IT
Hellas Verona,36,25.7,44.4,38,29,67,35,3,7,88,6,38.0,32.4,27.2,59.6,539,1122,2023,IT
Inter,27,29.1,57.1,87,60,147,74,13,14,46,1,78.2,67.4,55.6,123.0,720,1620,2023,IT
Juventus,31,26.5,48.5,52,37,89,49,3,5,87,2,54.6,50.6,39.6,90.2,709,1473,2023,IT
Lazio,22,28.2,53.3,46,30,76,42,4,4,101,5,46.5,43.4,32.9,76.4,716,1528,2023,IT
Lecce,26,24.9,44.9,30,23,53,27,3,5,89,5,43.1,39.2,30.6,69.9,635,1183,2023,IT
Milan,35,26.6,56.9,76,56,132,70,6,8,82,8,66.2,60.0,46.0,106.0,898,1569,2023,IT
Monza,31,26.8,53.5,38,29,67,34,4,5,88,5,39.5,35.9,27.8,63.8,723,1248,2023,IT
Napoli,29,27.2,60.9,54,36,90,48,6,10,77,5,61.4,53.3,42.9,96.2,803,1758,2023,IT
Roma,30,27.7,54.9,64,44,108,53,11,12,95,3,51.4,42.3,34.4,76.7,682,1469,2023,IT
Salernitana,39,27.3,44.5,32,25,57,30,2,2,91,3,30.3,28.7,22.4,51.1,499,1119,2023,IT
Sassuolo,30,26.4,43.8,42,28,70,35,7,8,71,4,39.8,33.8,25.9,59.7,636,1301,2023,IT
Torino,30,26.4,51.6,35,29,64,33,2,2,75,2,37.7,36.1,30.1,66.2,710,1333,2023,IT
Udinese,32,25.7,39.3,36,23,59,33,3,4,94,5,39.1,36.8,28.0,64.9,601,1022,2023,IT
